clip	cut
produce	manufacture,create,harvest
defeat	beat
lime	plum,cranberry,grapefruit,apricot,strawberry,orange,lemon,banana,cherry,coconut,pineapple,grape,peach,pear,tangerine,apple
shade	shadow,color
train	glider,frigate,jet,car,tanker,yacht,helicopter,ambulance,battleship,fighter,bomber,bus,truck,ferry,van,scooter,motorcycle,practice
currant	grape,strawberry,cranberry
memory	store,mind
freedom	liberty,independence
crook	criminal
order	family,direction,society,class,law,instruction,gild,rank,rule,direct,civilization,peace,organization,community
chicken	coward,rooster
swordfish	tuna
cloak	coat,underpants,sweatshirt,sweater,jacket,robe,shirt,pants,pullover,apron,dress,trouser,trousers,scarf,sock,pant,hat,stockings,fleece,raincoat,blouse,glove,vest,socks,mask,stocking,bra
lid	cap,top
underpants	robe,cloak,coat,vest,blouse,glove,jacket,sweater,scarf,dress,hat,shirt
culture	civilization,cultivate
score	mark,account
add	join
yard	garden
glove	pullover,scarf,beret,vest,apron,bra,mitten,socks,sweater,trouser,stockings,jacket,coat,shirt,mask,cap,pants,sock,stocking,underpants,dress,trousers,cloak,robe,fleece,blouse,hat,bonnet,sweatshirt,pant,raincoat
glass	corkscrew,jar,mug,fork,knife,sieve,bowl,spoon,bottle,eyeglass
turnip	cauliflower,beans,radish,bean,carrot,corn,parsley,broccoli,lettuce,potato,spinach,cabbage,garlic,celery,onion,beet,horseradish,cucumber
shape	form,mold,manufacture
poison	corrupt,contaminate
drill	wrench,rake,screwdriver,hammer,hatchet,saw,chisel,practice
breakfast	eat
design	pattern,create
hood	hat,scarf
record	tape,log,account,page,book
superior	head,high
pagan	idol
highway	freeway
vehicle	car
error	slip,mistake
harp	trumpet,guitar,flute,cello,piano,violin,saxophone,clarinet
report	statement,cover,account
female	bitch,woman,girlfriend,girl
door	doorway
pretend	act,lie
voice	speak
newspaper	paper,rag
fall	harvest,lower,waterfall
catfish	whale,carp,herring,mackerel,trout,cod,tuna,dolphin,goldfish,salmon
water_vapor	steam
smart	charm,learn,sharp
machine	computer,instrument,tool
potato	beet,cabbage,broccoli,bean,cauliflower,corn,garlic,celery,turnip,cucumber,radish,carrot,onion,lettuce,parsley,spinach,beans,leek
freezer	fridge,toaster,stereo,dishwasher,oven,washer,television,stove,radio,telephone,refrigerator,phone
high	noble,tower,stone,superior,long
zebra	giraffe,horse
orangutan	gorilla
fold	bend
show	program,appear
engage	busy,interest
weed	cannabis
me	i,mine
policeman	pig
article	column,object,story,feature
dinner	eat,lunch
fir	cedar,cypress,pine
creation	art
nice	fine,kind,friendly,charm,sweet
city	town
pay	payment,fee
arithmetic	math
know	understand
soul	ghost,life
cat	coyote,donkey,lion,goat,tiger,dolphin,cougar,deer,panther,fox,horse,sheep,giraffe,rabbit,rat,pig,cow,leopard,elephant,whale,bear,bull,squirrel,jaguar,dog,beaver,gorilla
stairway	step
tear	chew
bear	coyote,donkey,lion,pig,horse,tiger,squirrel,rat,rabbit,giraffe,dolphin,elephant,beaver,fox,bull,cow,gorilla,whale,deer,sheep,cat,goat,dog,carry,birth
clothe	dress
salamander	lizard
buffalo	cow
orange	lime,lemon,grapefruit
conclusion	end
crocodile	alligator,snake
cook	bake
goal	purpose
sieve	plate,wrench,shovel,dagger,rake,scissors,hammer,screwdriver,spade,plier,colander,hatchet,spear,pliers,knife,saw,scalpel,fork,scissor,tweezer,glass,pincer,spoon,tweezers,chisel,corkscrew,pincers,sword
paw	hand,foot
gift	present,give
moon	satellite
cold	chill,freeze,cool
rinse	wash
illuminate	light
hawk	sparrow,eagle,robin,goose,vulture,swan,owl,crow,falcon,pheasant,pigeon,dove,penguin,woodpecker
crush	squash
penguin	robin,woodpecker,eagle,falcon,dove,owl,crow,vulture,sparrow,swan,hawk,goose,pheasant,pigeon,gull,duck
hallway	hall,passageway
mine	me
victory	win,success
cavity	pit,hollow,hole
balance	account,scale
worker	labor
watch	look
lower	fall
pole	staff
down	low
blueberry	strawberry,grape,cranberry
truck	bus,battleship,glider,ferry,bomber,scooter,tanker,helicopter,moped,jet,frigate,tractor,ambulance,yacht,car,bike,motorcycle,bicycle,motorbike,train,van,fighter
foyer	lobby,hall
hollow	cavity
square	place
wrench	pincer,drill,screwdriver,saw,sieve,scissors,mallet,rake,chisel,scissor,spoon,tweezers,spade,corkscrew,plier,hammer,hatchet,fork,knife,nutcracker,pliers,shovel,tweezer,pincers
trouble	suffer,pain,sorrow,row
toad	frog,snake,alligator
row	line,fight,argument,trouble
male	boy,boyfriend,bull
gull	penguin
language	phrase,speech,tongue
exist	be
falcon	woodpecker,pigeon,penguin,robin,eagle,pheasant,sparrow,hawk,dove,vulture,swan,owl,crow,goose
night	sunset,dark,darkness
donkey	cat,whale,coyote,bear,gorilla,mule,dolphin,fox,cow,deer,horse,elephant,bull,pig,rabbit,beaver,rat,lion,giraffe,tiger,goat,dog,squirrel,sheep
antelope	goat
shirt	dress,blouse,cloak,coat,vest,apron,robe,socks,jacket,trousers,scarf,stocking,glove,hat,sweater,fleece,sweatshirt,pullover,stockings,raincoat,bra,sock,pants,trouser,pant,underpants
raise	increase,rise,lift
bonobo	gorilla
couch	dresser,desk,stool,sofa,bookcase,wardrobe,table,chair,bed
chair	bookcase,bed,wardrobe,table,desk,dresser,couch,sofa,stool
waterfall	fall
cloudy	fog
stiff	die
leek	garlic,potato,onion
rocket	helicopter,missile,jet,glider,fighter,bomber
suitcase	box,bag
awaken	move
boss	mate,leader,head
knob	button
corn	beet,cabbage,parsley,lettuce,garlic,celery,turnip,potato,carrot,radish,bean,broccoli,cauliflower,beans,cucumber,onion,spinach
mallet	screwdriver,wrench,hammer,rake,hatchet,saw,chisel
ram	pack
subject	matter,head
battle	action,conflict
sugar	sweet
mosquito	grasshopper,cockroach,beetle,moth,wasp,hornet,ant,butterfly
bird	girl
restrict	bind
gecko	lizard
frog	turtle,toad,lizard,alligator,bullfrog,snake
destroy	kill,break,consume
piece	part,bite
paint	color,ink
shop	pub,hotel,restaurant,store,buy
jug	bowl,mug,jar,bottle
fire	shoot,burn
cast	throw,mold
smooth	even,flat
contact	touch
fine	nice,thin,good,powder,cool
country	nation
understand	see,get,know,read,knowledge,head,agreement
head	brain,top,master,superior,subject,mind,crown,understand,boss,lead,think,leader
okapi	giraffe
beach	sand
guppy	goldfish
kazoo	guitar,violin,flute,cello,piano,clarinet,trumpet,saxophone
oboe	cello,trumpet,flute,piano,clarinet,violin,guitar,saxophone
hold	power
whole	unbroken
temperature	fever,hot
plot	lot,action
prime	bloom,quality
end	close,purpose,point,conclusion
car	frigate,moped,motorbike,train,tanker,bus,motorcycle,glider,ambulance,battleship,bicycle,helicopter,bike,van,truck,bomber,scooter,ferry,fighter,jet,yacht,tractor,vehicle,wagon,automobile
exit	leave
wet	rain
dirty	naughty
ship	boat
cover	house,report,close,top,protect
half	side
mind	idea,reason,mood,head,memory,listen,brain
lunch	eat,dinner
skin	film,bark
credit	faith
medicine	drug
gooseberry	strawberry,grape,cranberry
face	look,side,surface
improve	advance
duck	swan,goose,penguin
direct	order
trout	cod,herring,dolphin,carp,catfish,goldfish,mackerel,whale,tuna,salmon
contract	get,agreement,compress,deal
quality	prime
dolphin	gorilla,sheep,salmon,goat,beaver,horse,elephant,cat,trout,coyote,donkey,cow,bull,rabbit,lion,tiger,carp,pig,bear,tuna,goldfish,squirrel,giraffe,rat,catfish,mackerel,dog,herring,cod,fox,deer,whale
lemon	peach,cranberry,tangerine,lime,apricot,cherry,coconut,orange,grape,grapefruit,plum,pear,apple,strawberry,banana,pineapple
pan	saucepan
department	school
fancy	like,pleasure
coach	bus
rhinoceros	elephant
construction	construct,make,build
complicate	complex
peace	rest,order
wing	fly
touch	handle,move,contact,feel
chest	box,breast,trunk,case
vulture	sparrow,pheasant,hawk,woodpecker,robin,penguin,crow,falcon,swan,eagle,dove,goose,owl,pigeon
idea	mind,image
work	labor,practice,job,active,function
radish	broccoli,cucumber,turnip,celery,carrot,beet,garlic,onion,cabbage,corn,bean,parsley,potato,spinach,lettuce,beans,horseradish,cauliflower
armor	plate
trade	business,commerce,deal
gown	dress
satisfaction	pleasure
pack	compress,ram,box
channel	sound
hand	paw,deal
gay	homosexual
box	drawers,bowl,chest,drawer,mug,jar,trunk,suitcase,bag,basket,bottle,box,pouch,case,tv,blow,computer,pack
alley	walk,aisle
alligator	snake,turtle,crocodile,lizard,frog,toad
lease	rent
tavern	hotel,restaurant,pub
battleship	truck,frigate,van,yacht,ferry,bus,canoe,car,scooter,ambulance,tanker,train,bomber,jet,helicopter,raft,kayak,motorcycle,fighter,glider,motorboat,caravel
cricket	butterfly,ant,moth,hornet,cockroach,wasp,grasshopper,beetle
crop	harvest
candy	sweet
listen	hear,mind,note
scene	view
learn	smart,read,study,knowledge
stocking	jacket,blouse,shirt,coat,sweater,dress,glove,vest,robe,scarf,hat,cloak
set	movement,fix,collection,lot,group,club
dish	plate
slip	error,mistake,stumble
sidewalk	pavement,walk
polish	wax,perfect
home	house,dwell,residence
fork	pincer,chisel,plier,hatchet,rake,napkin,scissor,saw,tweezer,spoon,screwdriver,wrench,sieve,glass,pliers,tweezers,corkscrew,shovel,hammer,spade,plate,nutcracker,knife,scissors,pincers
shoot	fire,hit
dream	vision
ruler	leader
stream	brook,flow
swallow	woodpecker,pigeon,robin,sparrow,dove,consume,eat,take
like	enjoy,love,fancy
traffic	commerce,travel
use	practice,wear,handle,benefit,consume,function
rough	bumpy
hope	want
heat	hot,warm
cabinet	closet
art	creation
company	business
wolf	coyote,fox
powder	fine
rain	shower,wet
enjoy	like
bagpipe	cello,saxophone,guitar,piano,violin,clarinet,flute,trumpet
sock	jacket,hat,sweater,coat,blouse,cloak,glove,dress,vest,robe,scarf,shirt
freeze	cold
clock	time
tour	travel,move
strike	blow
appear	present,show,come,be,arrive,look
sofa	bed,wardrobe,bookcase,table,dresser,couch,desk,chair,stool
pick	choose,harvest,screen,decide
shovel	chisel,pliers,sieve,knife,screwdriver,spade,pincers,pincer,corkscrew,spoon,tweezer,saw,hammer,rake,fork,scissors,scissor,hatchet,wrench,tweezers,plier
age	old
figure	image
split	break,divide,division,cleave,divorce
mouse	beaver,rat,squirrel
woman	female,lady
spike	nail,hit
park	garden
sage	parsley
leopard	cat,lion,tiger
joy	delight,pleasure,happiness
owl	penguin,swan,hawk,robin,sparrow,dove,eagle,pheasant,falcon,goose,woodpecker,vulture,crow,pigeon
follow	tail
cherry	peach,pear,lemon,plum,lime,banana,grape,grapefruit,strawberry,coconut,pineapple,apricot,cranberry,apple
dislike	disgust
team	gang
cattle	cow
crowd	group,lot
apartment	flat
land	property,earth,soil
parsley	spinach,lettuce,corn,rosemary,carrot,celery,garlic,turnip,broccoli,radish,cilantro,onion,cucumber,cauliflower,potato,bean,cabbage,beet,beans,sage
hot	heat,steal,temperature,boil
live	move
old	age,past
column	article,post
man	john
iguana	lizard
canoe	battleship,yacht,tanker,frigate,ferry
robe	trousers,underpants,fleece,trouser,sweater,vest,socks,hat,cloak,jacket,stockings,shirt,scarf,sweatshirt,bra,apron,coat,pant,stocking,sock,glove,raincoat,pants,dress,blouse,pullover
knot	knit,tie,bind
friend	girlfriend,mate,boyfriend,lover
solid	hard
sign	mark
rifle	cannon,missile,gun,dagger,musket,spear,bomb,sword,revolver,pistol,pike,Kalashnikov,kalashnikov,bazooka,bow,knife,hatchet,grenade,shotgun
locust	cockroach,hornet,grasshopper,beetle,ant,wasp,moth,butterfly
even	equal,level,flat,smooth
injure	damage,hurt
pin	nail
nail	hammer,screw,spike,pin
court	courthouse,field
breast	chest
bomb	knife,bow,spear,musket,pistol,cannon,grenade,rifle,bazooka,missile,revolver,gun,dagger,sword,shotgun,hatchet,Kalashnikov,kalashnikov,pike
insect	bug
finger	handle
law	order,police
vision	sight,dream,view
pupil	follower,student
death	die
mound	hill
suck	draw
incline	bend
missouri	mississippi
serve	service,function
synagogue	cathedral
heart	emotion,core,spirit,feel,courage,love,affection,will
noble	high
love	baby,lover,heart,like,darling,affection,honey,mate
rear	back
tiger	beaver,whale,squirrel,cat,lion,dolphin,pig,rat,fox,bear,jaguar,gorilla,bull,elephant,horse,cow,coyote,giraffe,donkey,panther,goat,deer,rabbit,sheep,dog,cougar,leopard
drink	alcohol
study	learn,look,read
Kalashnikov	gun,sword,musket,revolver,rifle,pistol,grenade,dagger,missile,cannon,bomb,spear
bring	get
enlightenment	knowledge
movie	picture,film
grass	cannabis
close	finish,end,cover,narrow
goat	dolphin,lion,deer,pig,cat,fox,bull,horse,whale,giraffe,ibex,beaver,sheep,dog,donkey,elephant,squirrel,rat,coyote,tiger,rabbit,cow,gorilla,bear,antelope
challenge	problem,test
scissor	knife,spade,saw,corkscrew,fork,wrench,chisel,screwdriver,sieve,spoon,shovel,rake,hatchet,hammer
bull	sheep,giraffe,pig,dolphin,goat,whale,tiger,donkey,deer,squirrel,gorilla,coyote,beaver,elephant,lion,bear,rat,rabbit,fox,horse,cat,cow,dog,male
carrot	radish,parsley,lettuce,cucumber,turnip,broccoli,onion,garlic,beans,corn,potato,cauliflower,bean,celery,beet,cabbage,spinach
demand	need
chimpanzee	gorilla
cannabis	weed,grass
jar	mug,jug,chalice,bottle,glass,bowl,bag,box,plate,tumbler,pot
perfect	polish
personal	individual,familiar
bread	food
mobile	cell_phone
sink	low
moose	deer
beret	glove,hat,scarf
basement	cellar
pliers	rake,shovel,spoon,hatchet,corkscrew,sieve,screwdriver,hammer,chisel,fork,wrench,spade,knife,saw
celery	beet,radish,parsley,corn,garlic,spinach,broccoli,cucumber,cauliflower,potato,lettuce,bean,turnip,onion,carrot,cabbage,beans
homosexual	queen,gay
tribe	type
program	show
desk	table,couch,stool,wardrobe,bookcase,sofa,chair,bed,dresser
ambulance	bike,van,car,bomber,bus,battleship,ferry,train,truck,yacht,motorcycle,frigate,motorbike,fighter,jet,scooter,glider,moped,helicopter,tanker,tractor,bicycle
scale	climb,balance
die	death,cube,stiff,dice,pass
tool	machine
noise	sound
mango	pineapple,coconut,banana
sharp	point,smart,cut,razor,bitter
consume	swallow,destroy,use,burn,eat
pianoforte	guitar,cello,flute,clarinet,saxophone,violin,trumpet
rake	plier,pliers,pincers,fork,sieve,drill,spade,wrench,saw,corkscrew,chisel,mallet,knife,hatchet,scissors,screwdriver,spoon,shovel,tweezer,pincer,scissor,hammer,tweezers
banjo	cello,flute,clarinet,trumpet,violin,guitar,saxophone,piano
fee	pay
action	exercise,battle,energy,conflict,play,plot,prosecution,performance,movement,act
hit	spike,blow,shoot
relaxation	recreation,relax
pigeon	blackbird,sparrow,falcon,crow,swallow,goose,swan,hawk,pheasant,eagle,woodpecker,robin,penguin,vulture,owl,dove
lion	rat,bear,goat,cat,whale,tiger,dolphin,jaguar,deer,squirrel,rabbit,gorilla,dog,pig,elephant,cow,sheep,donkey,giraffe,bull,leopard,fox,coyote,beaver,panther,horse,cougar
fasten	tie,connect,belt,catch,lace,bind,join,attach
pleasure	satisfaction,happiness,delight,joy,fancy,fun,enjoyment
cultivate	culture,grow
vessel	container,boat
brick	cube
fail	break
ring	band,telephone,circle,phone
hippopotamus	elephant
plane	airplane
llama	sheep
energy	power,action
criminal	crook
master	head,captain
draw	pull,suck
oriole	robin
power	muscle,energy,weight,main,control,pull,hold
view	look,sight,see,point,scene,vision
grasshopper	mosquito,silverfish,moth,beetle,fly,locust,ant,butterfly,bee,hornet,wasp,cockroach,ladybug,dragonfly,cricket
hatchet	corkscrew,dagger,cannon,sword,fork,pincer,tweezer,screwdriver,hammer,pliers,musket,revolver,knife,sieve,spear,mallet,wrench,rake,chisel,scalpel,spoon,grenade,drill,pincers,saw,gun,pistol,bomb,spade,missile,tweezers,shovel,rifle,scissor,scissors,plier
fly	grasshopper,butterfly,beetle,hornet,moth,wasp,cockroach,ant,escape,rise,wing,flight
purity	integrity
leader	lead,boss,ruler,head
plain	ordinary
moped	scooter,car,truck,motorcycle,bus,ambulance,van
revolver	kalashnikov,pistol,shotgun,bow,knife,cannon,grenade,hatchet,gun,rifle,bazooka,sword,pike,dagger,Kalashnikov,bomb,missile,musket,spear
handle	touch,deal,feel,finger,pull,use
shower	rain
cellar	basement
advance	improve,approach
bit	part
plan	pattern,purpose,map
play	game,drama,action
terrapin	turtle
success	victory,succeed
air	atmosphere
smoke	cigarette
busy	active,engage
game	play,recreation,sport,entertainment,fun,match
cord	wire,string,line,flex
flex	cord,bend,give
construct	manufacture,form,assemble,build,construction,make
herring	mackerel,salmon,trout,carp,cod,catfish,whale,tuna,dolphin,goldfish
motorboat	frigate,ferry,yacht,tanker,battleship
pitch	field,throw
stereo	freezer,television,computer,oven,dishwasher,phone,fridge,toaster,stove,radio,refrigerator,washer,telephone
depress	low
fun	enjoyment,pleasure,game
idol	pagan,image,darling,god
up	increase,bounce
match	mate,game
bike	bus,ambulance,car,van,motorcycle,truck,scooter,bicycle
son	john
jackal	fox,coyote
bath	bathtub,bathroom
cilantro	parsley
have	get,carry
dot	point,spot
piano	ukulele,organ,mandolin,cello,trumpet,bagpipe,saxophone,oboe,kazoo,guitar,drum,clarinet,harp,trombone,flute,violin,sax,banjo,bass,harmonica,horn
act	performance,move,pretend,action
pass	road,die,give
lead	leader,head
bend	incline,curve,flex,turn,bow,fold
refuse	trash,waste,garbage,rubbish
rabbit	rat,dog,cow,elephant,dolphin,hare,lion,cat,bear,pig,donkey,whale,deer,coyote,beaver,giraffe,squirrel,goat,fox,bull,horse,sheep,tiger,gorilla
speech	speak,language
beet	cabbage,potato,corn,garlic,celery,radish,lettuce,cauliflower,spinach,beans,cucumber,onion,bean,carrot,turnip,broccoli,parsley
separate	divide,space,divorce,separation,part
fight	conflict,row
cottage	warehouse,restaurant,hotel,cathedral,inn,villa,pub,castle,hospital,library
horse	dolphin,rat,bear,coyote,whale,sheep,cat,fox,donkey,goat,elephant,tiger,cow,giraffe,beaver,squirrel,gorilla,rabbit,dog,mule,bull,zebra,lion,pig,deer
saxophone	flute,organ,clarinet,trombone,guitar,bagpipe,drum,trumpet,cello,piano,violin,ukulele,harmonica,pianoforte,bass,kazoo,banjo,horn,harp,mandolin,oboe
cucumber	radish,cabbage,squash,broccoli,carrot,watermelon,lettuce,garlic,beans,celery,beet,onion,potato,spinach,parsley,cauliflower,bean,corn,turnip
sheep	dolphin,mouflon,giraffe,bull,whale,horse,cat,gorilla,llama,beaver,squirrel,goat,lion,cow,elephant,pig,deer,rat,coyote,bear,rabbit,tiger,camel,fox,donkey,dog
club	staff,set
band	ring,stripe,group
hammer	spade,knife,corkscrew,scissors,tweezers,hatchet,anvil,scalpel,pincer,mallet,sieve,screwdriver,chisel,saw,plier,drill,sledgehammer,wrench,pliers,nail,spoon,shovel,tweezer,fork,rake,nutcracker,pincers,scissor,beat
spade	hammer,corkscrew,scissor,shovel,screwdriver,rake,sieve,pincer,scissors,knife,wrench,spoon,plier,chisel,saw,fork,pliers,hatchet,pincers,tweezers,tweezer
hostility	war
plier	rake,fork,saw,sieve,screwdriver,hammer,wrench,spoon,spade,corkscrew,chisel,knife,hatchet,shovel
experiment	test
feature	article
back	rear,reverse
huge	great
lettuce	parsley,corn,carrot,beet,cucumber,beans,onion,spinach,turnip,celery,broccoli,potato,bean,cabbage,radish,cauliflower,garlic
socks	coat,robe,blouse,glove,vest,shirt,hat,scarf,jacket,cloak,sweater,dress
enrage	anger
flight	fly
secret	mystery
matter	problem,subject,purpose,stuff
crown	title,head
mistake	confuse,slip,error,stumble
scissors	hammer,wrench,saw,sieve,spade,knife,screwdriver,spoon,rake,shovel,chisel,hatchet,fork,corkscrew
approach	push,drive,advance
dresser	bookcase,bed,couch,table,sofa,wardrobe,chair,stool,desk
surface	pavement,face
gang	team,circle
castle	skyscraper,hospital,warehouse,hotel,library,restaurant,cathedral,cottage,pub,villa
courage	bottle,heart
illness	sickness,disease
bake	cook,boil
priest	father
salmon	dolphin,herring,cod,carp,tuna,goldfish,whale,catfish,trout,mackerel
grapefruit	lime,cranberry,coconut,apricot,plum,banana,cherry,lemon,apple,strawberry,pear,grape,peach,pineapple,tangerine,orange
sea	marine,ocean
cleave	split
rubber	eraser
necktie	scarf
great	huge
mate	boss,couple,friend,friendly,love,match
short	low
chew	bite,tear,grind
thin	fine,narrow
full	overflow,complete,jam,stuff,satisfy
bandanna	scarf
television	stereo,radio,computer,phone,oven,stove,freezer,dishwasher,telephone,fridge,toaster,washer,refrigerator,tv
service	serve
community	nation,order
try	trial
onion	cauliflower,garlic,lettuce,beans,cabbage,carrot,radish,broccoli,cucumber,beet,turnip,potato,celery,parsley,spinach,corn,bean,scallion,leek
jam	full
chisel	corkscrew,scalpel,fork,shovel,pincer,tweezer,spoon,saw,wrench,hammer,rake,knife,scissor,hatchet,pliers,spade,plier,scissors,sieve,screwdriver,pincers,nutcracker,drill,tweezers,mallet
elevator	lift
frigate	car,train,battleship,yacht,glider,truck,jet,motorboat,ferry,helicopter,caravel,ambulance,fighter,bus,van,tanker,scooter,bomber,motorcycle,raft,canoe,kayak
class	order,type
rooster	chicken
whale	catfish,elephant,donkey,carp,tiger,giraffe,lion,horse,sheep,deer,herring,gorilla,cod,bull,goat,beaver,trout,dog,tuna,rabbit,mackerel,fox,cow,bear,goldfish,coyote,cat,salmon,pig,rat,squirrel,dolphin
world	earth,globe,life
create	manufacture,produce,make,build,design
cabbage	beet,broccoli,corn,cucumber,beans,potato,onion,garlic,radish,turnip,lettuce,celery,parsley,spinach,cauliflower,carrot,bean
movement	travel,set,action
base	bad
steam	water_vapor,fog
bin	trash,container,toss
mississippi	missouri
honey	sweet,love
trousers	scarf,robe,sweater,dress,hat,shirt,cloak,coat,blouse,jacket,vest,glove
reduce	cut,low
ascend	climb,rise
blue	low
mix	combine
friendly	gentle,familiar,nice,kind,mate
rubbish	waste,trash,nonsense,garbage,refuse
lover	girlfriend,love,boyfriend,friend
anvil	hammer
phone	dishwasher,toaster,radio,stove,television,oven,stereo,refrigerator,fridge,washer,freezer,computer,telephone,call,ring
brook	stream
lady	woman
young	new,small
eyeglass	glass
rise	climb,fly,increase,ascend,raise
butterfly	cricket,beetle,moth,ant,fly,silverfish,cockroach,grasshopper,wasp,hornet,ladybug,bee,dragonfly,mosquito,locust
stuff	matter,full
soft_drink	pop,soda
cheat	deceive
elephant	whale,squirrel,fox,dolphin,rabbit,rhinoceros,hippopotamus,donkey,horse,tiger,pig,lion,bear,sheep,dog,hippo,bull,beaver,giraffe,cow,goat,coyote,rat,gorilla,cat,deer,mammoth,rhino
time	clock,long,point,life
fur	coat
sleep	rest
keep	protect,carry,care,save
coward	chicken
pub	bar,cottage,shop,hotel,cathedral,hospital,villa,restaurant,castle,tavern,library,inn,store
enjoyment	delight,happiness,fun,pleasure
chameleon	lizard
wed	marriage,marry
pot	jar,toilet
deep	dark
tide	flow
restaurant	villa,cottage,hospital,castle,cathedral,library,pub,tavern,shop,inn,bar,hotel,store
make	create,construction,manufacture,construct
hop	jump
mackerel	herring,carp,goldfish,catfish,cod,trout,whale,dolphin,salmon,tuna
fleece	scarf,robe,hat,coat,dress,vest,shirt,jacket,cloak,blouse,glove,sweater
blouse	sweater,raincoat,scarf,coat,bra,socks,apron,jacket,vest,stocking,shirt,trouser,pant,sock,dress,trousers,underpants,stockings,hat,sweatshirt,cloak,fleece,robe,pullover,glove,pants
dark	darkness,night,deep,black
dice	cube,die
compress	squash,pack,compact,press,contract
camel	sheep
escape	fly
talk	speak
hospital	clinic,library,restaurant,castle,cathedral,hotel,pub,villa,school,cottage,warehouse
bitter	sharp
level	even
girl	bird,girlfriend,child,female
independence	separation,liberty,freedom
stumble	slip,mistake
mail	post
group	collection,crowd,band,lot,set,circle
nonsense	rubbish
glider	train,tanker,jet,truck,frigate,car,helicopter,bus,motorcycle,yacht,bomber,ferry,fighter,scooter,rocket,van,battleship,ambulance
leisure	relax
hare	rabbit
artist	author
ignite	light
ferry	bomber,motorcycle,jet,helicopter,raft,truck,battleship,fighter,frigate,ambulance,motorboat,caravel,glider,yacht,van,bus,car,tanker,train,scooter,kayak,canoe
bias	prejudice
song	sing
charge	rush
grip	take
place	space,spot,rest,seat,point,square,room
steer	turn
album	disk
low	sink,flat,mean,blue,down,small,depress,short,reduce
cut	clip,sharp,reduce
pale	white,light
walk	pavement,alley,sidewalk,move
clay	earth
pheasant	goose,vulture,woodpecker,falcon,crow,sparrow,dove,hawk,pigeon,eagle,peacock,penguin,robin,owl,swan
library	villa,hospital,cathedral,castle,hotel,restaurant,bookstore,cottage,pub,warehouse
ham	bacon
pullover	glove,scarf,hat,dress,cloak,vest,coat,shirt,sweater,blouse,robe,jacket
elm	poplar,oak,pine,cypress,birch,willow,cedar,acacia
admire	respect
suffer	trouble,pain
jet	helicopter,ferry,glider,train,van,bus,fighter,yacht,truck,tanker,jet,frigate,rocket,bomber,battleship,motorcycle,ambulance,scooter,car
speak	talk,voice,speech
butch	kill
delight	enjoyment,joy,charm,pleasure
support	rest,stand,shore,aid,help
child	offspring,kid,boy,girl
unknown	strange
pouch	box,bag
mankind	humanity
direction	order
character	part
part	piece,bit,member,ingredient,character,division,element,side,organ,link,function,divide,separate,share
civilization	culture,order
image	idol,picture,figure,idea,form,copy
pincer	wrench,fork,screwdriver,hatchet,saw,chisel,hammer,spade,shovel,knife,sieve,rake,corkscrew,spoon
bathtub	bath
sickness	illness,disease
sorrow	trouble
washer	radio,oven,fridge,dishwasher,refrigerator,freezer,stove,phone,television,stereo,toaster,telephone
unhappiness	sadness
toss	throw,bin
helicopter	jet,tanker,ferry,glider,airplane,scooter,truck,rocket,motorcycle,train,bomber,car,van,fighter,frigate,yacht,battleship,ambulance,bus,helicopter
sweater	blouse,sweatshirt,coat,robe,jacket,trousers,raincoat,bra,sock,cloak,stockings,hat,glove,pant,shirt,vest,stocking,trouser,scarf,apron,dress,pants,pullover,fleece,underpants,socks
sight	spot,see,view,vision
see	understand,look,sight,view
sister	darling
curl	curve,arch
mean	equal,low,purpose,cheap
toaster	freezer,dishwasher,phone,oven,fridge,radio,stereo,refrigerator,telephone,television,stove,washer
climb	rise,ascend,scale
captain	master
point	sharp,spot,dot,time,mark,end,place,view
couple	mate
top	cap,head,cover,lid
fox	elephant,rat,gorilla,donkey,tiger,cat,goat,horse,giraffe,beaver,wolf,pig,dog,bear,whale,deer,squirrel,rabbit,cow,lion,bull,hyena,coyote,dolphin,sheep,jackal
bug	insect
white	light,pale
tower	high
unusual	strange
religion	faith
bonnet	hat,scarf,glove
harmonica	clarinet,guitar,violin,cello,saxophone,flute,trumpet,piano
help	benefit,aid,lift,support
comfort	relief,satisfy
blade	knife,sword
volume	size,space,book
backpack	bag
belief	faith,trust
humanity	mankind
garbage	waste,refuse,trash,rubbish
punishment	beat,pain
spark	begin
carp	whale,mackerel,catfish,herring,trout,dolphin,salmon,tuna,cod,goldfish
cell_phone	cell,mobile
bad	base
object	purpose,article
trumpet	guitar,cello,oboe,violin,harp,horn,drum,trombone,saxophone,piano,banjo,ukulele,clarinet,flute,kazoo,sax,bass,organ,harmonica,pianoforte,mandolin,bagpipe
thick	dense
book	note,volume,account,record
story	article,history,floor
give	gift,flex,move,pass
silverfish	cockroach,grasshopper,hornet,moth,butterfly,ant,beetle,wasp
break	vacation,split,dash,fail,destroy,rest
belt	fasten,pound,speed,circle
stone	rock,high
pool	pond
center	middle
spot	point,place,sight,dot,stain
trombone	saxophone,trumpet,violin,guitar,piano,cello,flute,clarinet
darling	sister,love,idol
separation	division,independence,separate,divorce
warm	heat
button	knob
field	pitch,court
text	write
boat	ship,vessel
vest	jacket,dress,stockings,glove,robe,blouse,socks,shirt,apron,fleece,hat,coat,sweater,bra,underpants,pant,trousers,stocking,scarf,sweatshirt,pullover,sock,cloak,pants,raincoat,trouser
tell	count
settle	fix,decide
green	new
clear	empty,clean
stair	step
store	restaurant,pub,hotel,write,memory,shop,stock
actor	actress
rosemary	parsley
move	touch,transport,act,awaken,carry,drive,live,give,tour,remove,walk
ant	butterfly,ladybug,wasp,grasshopper,locust,cricket,beetle,silverfish,moth,hornet,bee,cockroach,mosquito,fly,dragonfly
win	victory
hotel	cottage,villa,cathedral,castle,tavern,library,pub,hospital,shop,warehouse,inn,restaurant,store
lizard	chameleon,alligator,frog,gecko,iguana,snake,turtle,salamander
case	bag,box,jacket,chest
fighter	tanker,bomber,scooter,jet,ferry,van,motorcycle,helicopter,yacht,bus,train,glider,frigate,fighter,car,ambulance,battleship,rocket,truck
war	hostility
naughty	dirty
screw	screwdriver,nail
teach	instruction,school,education
content	satisfy
member	penis,part,element
save	protect,keep
beans	turnip,broccoli,cabbage,lettuce,onion,cucumber,beet,spinach,cauliflower,carrot,garlic,corn,radish,potato,parsley,celery
trial	test,practice,try
pavement	sidewalk,surface,walk,road
police	law
type	tribe,class,kind,pattern
toilet	bathroom,can,john,pot
problem	question,matter,challenge,catch
board	table,committee
prejudice	bias
knit	knot
unbroken	whole
ladybug	hornet,ant,moth,beetle,cockroach,butterfly,grasshopper,wasp
compete	competition
airplane	helicopter,plane
look	view,see,study,face,watch,appear
drug	medicine
effect	purpose
charm	smart,delight,nice
doorway	door
garden	yard,park
everything	all
dagger	hatchet,bow,musket,sieve,bazooka,rifle,pistol,grenade,cannon,corkscrew,missile,revolver,spear,gun,shotgun,bomb,Kalashnikov,kalashnikov,knife,pike,sword
complete	full,finish
jump	bounce,spring,hop
murder	kill
pistol	revolver,grenade,dagger,bomb,musket,missile,kalashnikov,rifle,bazooka,gun,knife,bow,sword,Kalashnikov,cannon,hatchet,spear,shotgun,pike
purse	bag
pig	giraffe,bear,coyote,goat,bull,tiger,squirrel,dolphin,dog,lion,elephant,cat,donkey,rabbit,fox,gorilla,sheep,boar,cow,deer,beaver,rat,whale,horse,policeman
strawberry	blueberry,plum,grape,lime,gooseberry,pear,cranberry,apple,apricot,pineapple,cherry,coconut,grapefruit,banana,currant,peach,lemon
divorce	separate,split,separation
stove	telephone,radio,phone,oven,dishwasher,television,freezer,stereo,fridge,washer,toaster,refrigerator
girlfriend	girl,lover,friend,female
scooter	moped,tanker,van,truck,fighter,helicopter,motorbike,battleship,bomber,yacht,bus,car,motorcycle,glider,bicycle,ambulance,frigate,jet,train,ferry,bike,tractor
ball	football,globe
stockings	vest,dress,sweater,robe,scarf,jacket,glove,coat,cloak,blouse,hat,shirt
panther	cat,tiger,lion
cannon	hatchet,missile,rifle,gun,revolver,bow,dagger,bomb,pike,kalashnikov,musket,pistol,grenade,sword,spear,bazooka,Kalashnikov,shotgun,knife
question	problem
squirrel	deer,elephant,tiger,giraffe,pig,rat,lion,bear,coyote,sheep,bull,dolphin,cow,goat,donkey,rabbit,hamster,fox,horse,gorilla,dog,cat,beaver,mouse,whale
shadow	shade
guitar	pianoforte,trumpet,harmonica,saxophone,harp,kazoo,bagpipe,sax,ukulele,cello,bass,piano,clarinet,trombone,banjo,horn,flute,oboe,organ,violin,mandolin,drum
woodpecker	falcon,eagle,penguin,swallow,pheasant,vulture,dove,goose,swan,blackbird,crow,pigeon,sparrow,hawk,robin,owl
costume	dress
get	contract,understand,have,take,catch,pull,bring
hippo	elephant
sword	shotgun,gun,hatchet,bazooka,kalashnikov,corkscrew,spear,rifle,Kalashnikov,musket,grenade,revolver,missile,pistol,bow,bomb,cannon,knife,pike,dagger,sieve,blade
reason	mind,purpose
baggage	gear,bag
account	record,score,balance,statement,book,report
bitch	female
bumpy	rough
inn	cottage,villa,hotel,restaurant,pub
watermelon	cucumber
information	knowledge,data
i	me
cloud	fog
bloom	prime,flower
pear	grape,plum,cherry,strawberry,banana,coconut,cranberry,apricot,apple,lemon,pineapple,peach,grapefruit,lime
affection	heart,love
mammoth	elephant
kid	child
push	approach,press,drive
nutcracker	spoon,knife,wrench,screwdriver,fork,corkscrew,chisel,hammer
drawer	box
stool	desk,couch,table,wardrobe,bed,bookcase,dresser,chair,sofa
shore	support
bass	violin,flute,guitar,cello,saxophone,trumpet,clarinet,piano
bomber	ferry,truck,fighter,ambulance,jet,scooter,helicopter,motorcycle,van,glider,bus,yacht,battleship,tanker,car,train,frigate,rocket
lace	string,fasten
lot	plot,deal,set,crowd,collection,group
novel	new
dessert	sweet
tweezers	hammer,wrench,corkscrew,fork,sieve,knife,hatchet,spade,screwdriver,saw,chisel,shovel,spoon,rake
confidence	trust,faith
bra	blouse,glove,sweater,coat,scarf,robe,vest,jacket,dress,hat,shirt,cloak
gentle	friendly,kind
coconut	apple,grapefruit,papaya,plum,apricot,grape,lemon,lime,pear,strawberry,cherry,banana,cranberry,peach,mango,pineapple
cathedral	cottage,library,hotel,villa,castle,hospital,mosque,restaurant,pub,warehouse,skyscraper,synagogue
garlic	beet,onion,radish,parsley,corn,cucumber,celery,cabbage,broccoli,carrot,potato,beans,turnip,spinach,lettuce,cauliflower,scallion,leek,bean
open	hole
football	ball
saw	wrench,plier,screwdriver,pincer,scissor,fork,scissors,scalpel,knife,rake,chisel,hammer,sieve,shovel,spade,tweezer,hatchet,corkscrew,pincers,drill,spoon,pliers,tweezers,mallet
new	young,strange,green,novel
knife	napkin,hammer,scissor,shovel,revolver,bomb,spoon,grenade,saw,gun,corkscrew,spade,hatchet,spear,nutcracker,chisel,sieve,rake,screwdriver,musket,scissors,pincer,pistol,wrench,scalpel,glass,tweezers,sword,tweezer,dagger,pincers,plate,missile,plier,rifle,fork,pliers,cannon,blade
villa	restaurant,library,hotel,cathedral,cottage,inn,hospital,pub,castle,warehouse
map	plan
dishwasher	oven,phone,freezer,fridge,toaster,refrigerator,stereo,washer,stove,radio,television,telephone
decide	choose,pick,settle
initial	begin
neckerchief	scarf
container	bin,vessel
burn	consume,fire
cougar	cat,tiger,lion
apricot	grape,lime,pineapple,apple,lemon,coconut,grapefruit,plum,strawberry,pear,cherry,peach,banana,cranberry
assemble	construct,build
familiar	friendly,personal
active	busy,work
build	increase,construct,manufacture,create,construction,assemble
bow	gun,dagger,revolver,cannon,bomb,spear,pistol,sword,missile,musket,rifle,grenade,bend,curve
limp	relax
bind	restrict,edge,tie,fasten,knot
automobile	car
coyote	bear,cat,rat,donkey,gorilla,pig,horse,wolf,dolphin,beaver,squirrel,tiger,bull,hyena,rabbit,elephant,cow,goat,sheep,whale,lion,giraffe,fox,jackal,deer,dog
wasp	moth,bee,ant,beetle,hornet,dragonfly,butterfly,grasshopper,mosquito,cockroach,fly,locust,cricket,ladybug,silverfish
cloth	material,fabric
integrity	purity,honesty
tumbler	mug,bowl,jar,bottle
bacon	ham
staff	club,stick,pole
grenade	musket,pistol,dagger,knife,revolver,bomb,shotgun,gun,missile,sword,bazooka,spear,pike,hatchet,Kalashnikov,cannon,rifle,kalashnikov,bow
sport	game
cigarette	smoke
blanket	sheet
page	sheet,record
papaya	coconut,pineapple,banana
boar	pig
instruction	teach,order
letter	note,line
boil	bake,hot
coffee	java
bar	pub,restaurant
exercise	action,practice
silver	silverware
present	gift,appear
sparrow	hawk,pigeon,vulture,goose,pheasant,falcon,swan,robin,penguin,owl,dove,woodpecker,swallow,crow,eagle,blackbird
school	hospital,teach,department,college,university
spouse	wife
conflict	fight,action,battle
device	instrument
sweet	honey,kind,candy,sugar,dessert,nice
father	priest
blow	wind,box,hit,strike
blackbird	pigeon,crow,robin,dove,woodpecker,sparrow
tanker	glider,helicopter,fighter,car,scooter,truck,bus,jet,train,yacht,battleship,motorcycle,van,bomber,canoe,caravel,ferry,frigate,kayak,ambulance,raft,motorboat
take	get,swallow,grip,remove,catch
comforter	quilt
will	heart
hem	edge
ukulele	piano,flute,clarinet,guitar,saxophone,trumpet,cello,violin
drum	clarinet,saxophone,trumpet,violin,piano,cello,guitar,flute
rock	stone
queen	homosexual
hear	listen
raincoat	jacket,blouse,sweater,dress,coat,hat,cloak,shirt,robe,scarf,vest,glove
university	college,school
penis	member
pit	cavity
van	jet,scooter,bus,battleship,tractor,ambulance,motorcycle,fighter,helicopter,car,bike,bomber,tanker,ferry,frigate,motorbike,bicycle,truck,glider,train,yacht,moped
organization	order
math	arithmetic
frame	rack
light	white,pale,knowledge,ignite,illuminate
pant	hat,blouse,sweater,cloak,coat,jacket,vest,robe,scarf,dress,shirt,glove,trouser
moth	grasshopper,wasp,butterfly,ladybug,silverfish,beetle,hornet,bee,mosquito,ant,cricket,cockroach,fly,dragonfly,locust
flag	standard
marriage	wed,union
stick	branch,staff
baby	love,offspring
test	trial,experiment,challenge
tractor	van,motorcycle,truck,ambulance,bus,car,scooter
purpose	goal,object,function,mean,reason,plan,matter,end,effect
flow	tide,stream
combine	mix
happiness	pleasure,enjoyment,joy
circle	disk,belt,gang,curve,ring,group
gear	baggage
link	connect,joint,part
commerce	trade,deal,traffic
cap	hat,glove,scarf,top,lid
form	construct,shape,image
computer	stereo,television,radio,phone,machine,box
human	person
data	information
fix	set,settle
race	nation,person,color
apple	coconut,banana,cranberry,apricot,pineapple,strawberry,grapefruit,pear,lemon,plum,grape,cherry,peach,lime
bathroom	toilet,bath
pop	soda,soft_drink
dress	vest,shirt,pullover,raincoat,hat,scarf,stockings,trousers,cloak,coat,apron,fleece,blouse,sock,stocking,glove,bra,sweater,sweatshirt,pant,pants,robe,underpants,jacket,socks,trouser,clothe,gown,costume
satisfy	content,comfort,full
gent	gentleman
relax	leisure,relaxation,rest,limp
beaver	deer,tiger,dolphin,giraffe,coyote,mouse,whale,hamster,fox,sheep,goat,donkey,bull,elephant,bear,rabbit,horse,cow,gorilla,pig,dog,lion,squirrel,rat,cat
mule	donkey,horse
call	phone,telephone
write	mark,store,author,text,pen,post
individual	personal
want	need,hope
leave	exit
cod	trout,salmon,herring,mackerel,whale,goldfish,carp,catfish,dolphin,tuna
recreation	game,relaxation
develop	expand
college	university,school
thread	string,line,wire
catch	fasten,get,stop,problem,take
waste	rubbish,garbage,refuse,trash
meat	food,flesh
raven	crow
number	count
weird	strange
mark	write,score,sign,note,point
read	learn,study,understand
post	write,column,mail
bicycle	car,bus,motorcycle,truck,van,scooter,ambulance,bike
buy	shop
darkness	dark,night
prosecution	action
cockroach	bee,silverfish,locust,beetle,mosquito,butterfly,hornet,ladybug,dragonfly,wasp,grasshopper,moth,cricket,fly,ant
flower	bloom
interest	engage
confuse	hard,mistake
clean	empty,clear
food	bread,meat,eat
outer_space	space
gun	sword,bow,cannon,rifle,Kalashnikov,missile,musket,shotgun,knife,revolver,grenade,bazooka,pistol,dagger,bomb,hatchet,kalashnikov,spear,pike
wax	polish
tail	follow,brush
life	experience,soul,time,world
lobby	foyer
curve	bend,curl,circle,bow
function	purpose,serve,part,use,work
pen	write
phrase	language
flat	low,even,dull,smooth,apartment
net	trap
wife	spouse
poem	lyric
cedar	fir,birch,pine,cypress,oak,acacia,poplar,willow,elm
deceive	cheat
equal	even,mean,be,same
property	land
writer	author
chimp	gorilla
bounce	jump,up
remove	take,move
pike	spear,cannon,rifle,revolver,missile,grenade,sword,dagger,gun,pistol,bomb,musket
quilt	comforter
caravel	ferry,frigate,tanker,yacht,battleship
turtle	alligator,frog,terrapin,snake,lizard,tortoise
bowtie	scarf
hall	hallway,foyer
chill	cold
napkin	knife,spoon,fork,corkscrew
disk	album,circle
planet	earth
bullfrog	frog
ordinary	plain
lift	aid,elevator,steal,help,ride,raise
turn	steer,bend
clarinet	saxophone,harmonica,drum,organ,banjo,ukulele,horn,cello,guitar,flute,oboe,piano,kazoo,pianoforte,trumpet,sax,bagpipe,bass,trombone,violin,harp,mandolin
dwell	residence,home,house
kayak	yacht,battleship,tanker,ferry,frigate
missile	cannon,rifle,gun,rocket,pistol,grenade,musket,kalashnikov,dagger,sword,bomb,spear,pike,shotgun,revolver,bow,bazooka,hatchet,Kalashnikov,knife
log	history,record
detail	complex
satellite	moon
cow	deer,dog,rabbit,dolphin,donkey,rat,gorilla,horse,lion,cat,tiger,sheep,squirrel,elephant,coyote,beaver,bear,giraffe,whale,pig,fox,goat,bull,buffalo,cattle
picture	image,movie
black	dark
courthouse	court
run	speed,travel
boyfriend	male,lover,friend
travel	movement,tour,traffic,run,trip
sheet	page,blanket
space	place,room,volume,separate,outer_space,blank
wardrobe	sofa,desk,chair,table,dresser,stool,bookcase,bed,couch
fever	temperature
muscle	power
past	history,old
ibex	goat
begin	spark,initial
room	space,place
telephone	oven,stove,fridge,freezer,television,toaster,radio,dishwasher,stereo,washer,phone,ring,call
mystery	secret
tuna	carp,goldfish,herring,dolphin,trout,whale,catfish,salmon,cod,swordfish,mackerel
trash	refuse,rubbish,bin,waste,garbage
razor	sharp
cube	dice,die,brick
lyric	poem
bean	turnip,potato,spinach,radish,celery,beet,lettuce,corn,carrot,cucumber,parsley,cauliflower,onion,broccoli,cabbage,garlic
agreement	contract,deal,understand
freeway	highway
cell	cell_phone
tread	step
labor	work,worker
pain	suffer,trouble,punishment
tangerine	lemon,grapefruit,lime
side	part,face,half,edge
state	nation
crow	eagle,dove,raven,pigeon,blackbird,robin,pheasant,penguin,hawk,vulture,swan,goose,woodpecker,sparrow,owl,falcon
population	nation
judge	think
sadness	unhappiness
hinge	joint
good	well,fine
closet	cabinet
beetle	cockroach,butterfly,grasshopper,hornet,mosquito,wasp,ladybug,fly,moth,locust,ant,bee,silverfish,cricket,dragonfly
shotgun	sword,revolver,musket,gun,grenade,spear,missile,dagger,bomb,pistol,cannon,rifle
bee	cockroach,wasp,grasshopper,moth,butterfly,ant,beetle,hornet
overflow	full
statement	report,account
screwdriver	wrench,scalpel,pincer,saw,mallet,shovel,hatchet,spade,hammer,sieve,drill,plier,pliers,scissor,fork,knife,corkscrew,scissors,spoon,tweezer,pincers,nutcracker,rake,screw,chisel,tweezers
nation	community,race,population,state,country
job	work
care	keep
you	person
hyena	coyote,fox
brake	stop
gentleman	gent
bill	note
small	young,little,low,minute
contaminate	poison
mouflon	sheep
entertainment	game
stain	color,spot
bookstore	library
java	coffee
motorbike	car,scooter,van,ambulance,truck,bus
hard	confuse,solid,complex
fog	cloud,steam,cloudy
ghost	soul,spirit
performance	act,action
element	part,member
rhino	elephant
deer	beaver,squirrel,cow,goat,impala,dog,whale,cat,donkey,lion,rat,gorilla,giraffe,bull,rabbit,sheep,fox,moose,pig,tiger,bear,elephant,dolphin,horse,reindeer,coyote
extinguish	quench
spear	pike,bomb,rifle,sword,musket,knife,kalashnikov,sieve,shotgun,bazooka,hatchet,bow,grenade,missile,dagger,cannon,pistol,revolver,corkscrew,gun,Kalashnikov
bookcase	dresser,sofa,chair,table,desk,couch,bed,wardrobe,stool
wind	blow
sew	stitch
beam	smile
kill	destroy,butch,murder
silverware	silver
protect	keep,save,cover
pond	pool
division	separation,split,part
helmet	hat
road	pass,pavement
pattern	plan,design,type
minute	small
town	city
pound	belt
follower	pupil
mandolin	piano,violin,flute,cello,guitar,trumpet,saxophone,clarinet
edge	hem,bind,line,side
dove	robin,eagle,crow,penguin,woodpecker,goose,pheasant,falcon,blackbird,hawk,sparrow,vulture,owl,swallow,swan,pigeon
atmosphere	air,feel,mood
emotion	heart,feel,mood
stop	brake,catch
boot	trunk,hoof
table	desk,dresser,sofa,bed,bookcase,chair,wardrobe,stool,couch,board
chalice	jar,bowl,mug,bottle
anger	enrage
bus	bike,motorcycle,truck,car,van,yacht,jet,battleship,tanker,glider,moped,ambulance,bomber,fighter,scooter,ferry,frigate,bicycle,train,motorbike,tractor,helicopter,coach
ink	paint
film	skin,movie
divide	split,separate,part,share
violin	sax,trumpet,harmonica,mandolin,kazoo,bass,drum,bagpipe,flute,saxophone,trombone,cello,banjo,oboe,harp,organ,piano,pianoforte,ukulele,guitar,clarinet,horn
weight	power
society	order
bottle	bowl,jug,jar,bag,plate,mug,chalice,box,glass,tumbler,courage
damage	hurt,injure
arrive	come,appear
tortoise	turtle
impala	deer
growth	increase,cancer
stitch	sew
trap	net
peacock	pheasant
bandana	scarf
sound	noise,note,channel
broccoli	radish,beans,cabbage,cucumber,cauliflower,spinach,carrot,potato,celery,garlic,onion,parsley,turnip,lettuce,corn,beet,bean
hat	cap,pant,hood,sock,pants,scarf,pullover,dress,fleece,mask,robe,beret,trousers,sweater,jacket,raincoat,sweatshirt,socks,helmet,vest,shirt,cloak,kippah,bonnet,blouse,stockings,mitten,coat,bra,glove,apron,stocking,underpants,trouser
practice	use,trial,work,exercise,drill,train
motorcycle	bus,ferry,car,tractor,van,helicopter,moped,glider,yacht,bomber,fighter,tanker,bike,ambulance,truck,bicycle,scooter,jet,battleship,frigate,train
think	judge,head
seat	place
john	boy,man,son,toilet
hole	open,cavity
dense	thick
peach	lemon,grape,cherry,banana,cranberry,plum,pear,apricot,strawberry,lime,coconut,grapefruit,pineapple,apple
mitten	glove,scarf,hat
eat	dinner,breakfast,food,swallow,lunch,consume
flute	saxophone,sax,ukulele,banjo,mandolin,oboe,pianoforte,harp,bass,violin,kazoo,clarinet,organ,harmonica,guitar,trumpet,piano,bagpipe,trombone,cello,horn,drum
respect	admire
bark	skin
committee	board
join	fasten,add,connect
dirt	soil
ocean	sea
spoon	napkin,knife,plate,pliers,chisel,nutcracker,wrench,pincers,corkscrew,fork,spade,shovel,plier,scissors,screwdriver,hammer,hatchet,rake,sieve,scissor,glass,saw,pincer,tweezer,tweezers
sand	beach
kalashnikov	revolver,sword,spear,pistol,missile,cannon,rifle,dagger,gun,grenade,bomb,musket
hamster	rat,beaver,squirrel
house	cover,home,dwell
pineapple	cranberry,apricot,apple,mango,strawberry,papaya,cherry,pear,lime,plum,grapefruit,banana,peach,lemon,coconut,grape
cool	cold,fine
wire	cord,thread
student	pupil
spirit	mood,heart,ghost
squash	cucumber,compress,crush
rank	order
soda	pop,soft_drink
scallion	garlic,onion
transportation	ride
well	good
accident	event
passageway	hallway
gild	order
alcohol	drink
rule	order
family	order
main	power
screen	pick
harvest	fall,crop,pick,produce
count	tell,number
plate	sieve,spoon,bowl,bottle,jar,mug,knife,fork,corkscrew,dish,armor
goose	pheasant,robin,sparrow,hawk,woodpecker,pigeon,dove,swan,crow,penguin,vulture,owl,eagle,falcon,duck
bag	mug,purse,bowl,basket,trunk,backpack,jar,wallet,bottle,suitcase,box,case,pouch,baggage
honesty	integrity
bazooka	dagger,sword,revolver,bomb,spear,grenade,gun,pistol,missile,cannon,rifle,musket
arch	curl
cauliflower	turnip,onion,spinach,beet,broccoli,potato,beans,celery,carrot,cucumber,parsley,lettuce,corn,bean,cabbage,garlic,radish
choice	range
collection	group,set,lot
quench	extinguish
oak	poplar,elm,birch,pine,cedar,acacia,cypress,willow
warehouse	cottage,castle,hotel,cathedral,villa,library,hospital
plum	pear,lime,strawberry,coconut,cherry,apricot,cranberry,grapefruit,grape,lemon,peach,apple,pineapple,banana
bite	chew,piece
rack	frame,stand
transport	move
boy	male,john,child
mug	bag,bowl,jug,jar,tumbler,glass,chalice,box,bottle,plate
saucepan	pan
little	small
same	equal
event	accident
all	everything
trouser	robe,blouse,glove,cloak,sweater,jacket,scarf,coat,shirt,vest,dress,hat,pant
spinach	parsley,cauliflower,beet,broccoli,celery,beans,bean,lettuce,turnip,cucumber,garlic,radish,potato,onion,cabbage,corn,carrot
pine	willow,acacia,cypress,cedar,oak,fir,poplar,elm,birch
brush	tail
dragonfly	wasp,cockroach,hornet,grasshopper,butterfly,moth,beetle,ant
faith	belief,religion,trust,credit,confidence
horn	trumpet,clarinet,guitar,cello,saxophone,flute,violin,piano
branch	stick
flesh	meat
strange	unusual,new,weird,unknown
fabric	material,cloth
cello	banjo,trumpet,pianoforte,bagpipe,oboe,piano,harmonica,harp,saxophone,guitar,sax,mandolin,kazoo,clarinet,violin,organ,ukulele,drum,trombone,bass,horn,flute
cranberry	lemon,lime,pineapple,grapefruit,apple,plum,banana,strawberry,grape,blueberry,pear,peach,coconut,cherry,currant,apricot,gooseberry
christian	kind
vacation	break
core	heart
kind	sweet,nice,gentle,friendly,type,christian
industry	manufacture
trip	drive,travel
pants	scarf,hat,cloak,glove,coat,jacket,dress,sweater,robe,vest,shirt,blouse
reward	payment
corrupt	poison
jack	steal
size	volume
musket	dagger,grenade,rifle,gun,hatchet,bomb,shotgun,pistol,spear,Kalashnikov,missile,sword,cannon,knife,revolver,bow,bazooka,pike,kalashnikov
rat	coyote,rabbit,giraffe,lion,horse,fox,gorilla,tiger,cow,squirrel,bear,deer,cat,hamster,dog,donkey,mouse,sheep,dolphin,elephant,goat,bull,pig,whale,beaver
jaguar	lion,tiger,cat
acacia	pine,cypress,poplar,birch,oak,cedar,willow,elm
brain	head,mind
pull	draw,handle,power,get
argument	row
narrow	thin,close
goldfish	mackerel,guppy,tuna,trout,cod,dolphin,whale,catfish,salmon,herring,carp
rag	newspaper
instrument	device,machine
benefit	help,use,aid
ceiling	roof
control	power
press	push,compress
organ	saxophone,piano,clarinet,flute,cello,violin,trumpet,guitar,part
unravel	solve
jacket	raincoat,vest,sock,sweater,blouse,stocking,cloak,robe,sweatshirt,hat,coat,shirt,stockings,glove,scarf,pants,bra,pant,fleece,trousers,trouser,socks,underpants,apron,dress,pullover,case
range	choice
birch	willow,oak,cedar,cypress,acacia,poplar,elm,pine
clinic	hospital
material	cloth,fabric
finish	close,complete
payment	pay,reward
basket	bag,box
union	marriage
colander	sieve
condor	eagle
fungus	mold
baboon	gorilla
cheap	mean
snake	alligator,turtle,crocodile,toad,frog,lizard
middle	center
globe	world,earth,ball
step	stair,tread,stairway
rest	support,sleep,peace,lie,place,relax,break
prison	jail
scalpel	chisel,screwdriver,saw,hammer,sieve,knife,hatchet,corkscrew
bowl	mug,bottle,jug,bag,box,plate,jar,chalice,tumbler,glass
blank	space
note	bill,book,letter,sound,mark,listen
beat	hammer,punishment,defeat
share	deal,stock,divide,part
yacht	frigate,bus,battleship,jet,train,scooter,tanker,motorcycle,kayak,glider,fighter,bomber,truck,ferry,ambulance,helicopter,canoe,raft,car,caravel,motorboat,van
empty	clean,clear
aid	lift,help,support,benefit
marry	wed
stand	support,rack
sweatshirt	coat,sweater,cloak,jacket,hat,robe,scarf,shirt,blouse,vest,dress,glove
spread	expand
increase	build,raise,up,rise,growth,expand,grow
grape	pear,strawberry,banana,apricot,peach,coconut,blueberry,currant,plum,cranberry,cherry,gooseberry,lemon,grapefruit,lime,apple,pineapple
feel	handle,heart,emotion,touch,atmosphere
dash	break
earth	world,soil,land,clay,globe,planet
foot	paw
oven	dishwasher,telephone,washer,toaster,fridge,stove,phone,stereo,freezer,television,radio,refrigerator
sledgehammer	hammer
need	demand,want
offspring	child,baby
can	toilet
birth	bear
fridge	freezer,dishwasher,washer,oven,radio,toaster,stereo,telephone,stove,phone,television
cancer	growth
sunset	night
compact	compress
tongue	language
apron	scarf,glove,blouse,shirt,cloak,dress,vest,robe,sweater,jacket,hat,coat
ride	drive,lift,transportation
bed	sofa,dresser,table,chair,bookcase,desk,stool,wardrobe,couch
competition	compete
steal	jack,hot,lift
copy	image
cypress	acacia,pine,fir,birch,poplar,cedar,oak,willow,elm
dog	rabbit,cow,deer,giraffe,pig,lion,rat,fox,elephant,whale,goat,donkey,dolphin,horse,squirrel,gorilla,beaver,tiger,cat,sheep,bull,bear,coyote
gorilla	dolphin,coyote,donkey,rat,fox,chimp,whale,tiger,orangutan,bonobo,sheep,lion,cow,deer,bull,pig,elephant,bear,beaver,horse,giraffe,squirrel,dog,goat,baboon,chimpanzee,cat,rabbit
swan	duck,robin,owl,hawk,woodpecker,goose,crow,vulture,sparrow,pigeon,falcon,penguin,dove,pheasant,eagle
tie	scarf,fasten,attach,bind,knot
corkscrew	chisel,hatchet,hammer,spade,scissor,napkin,sword,pliers,knife,glass,rake,spoon,wrench,shovel,dagger,tweezers,screwdriver,plier,pincers,fork,saw,sieve,pincer,spear,nutcracker,scalpel,plate,tweezer,scissors
spring	jump
pincers	rake,shovel,spoon,screwdriver,corkscrew,hatchet,spade,knife,saw,chisel,sieve,fork,hammer,wrench
mood	spirit,emotion,mind,atmosphere
horseradish	turnip,radish
wash	rinse
aisle	alley
jail	prison
skyscraper	castle,cathedral
trunk	bag,box,boot,chest
disgust	dislike
education	teach
banana	grape,apple,lime,peach,cranberry,grapefruit,cherry,pear,coconut,strawberry,lemon,plum,pineapple,apricot,papaya,mango
drama	play
god	idol
wagon	car
poplar	elm,oak,acacia,willow,cypress,pine,birch,cedar
mask	hat,glove,cloak,scarf
throw	toss,cast,pitch
tv	box,television
dull	flat
scarf	glove,pants,bandana,trousers,fleece,cravat,apron,blouse,hat,pullover,bandanna,dress,tie,bra,neckerchief,stockings,robe,mitten,shirt,coat,cloak,sweatshirt,hood,jacket,socks,necktie,sweater,vest,pant,stocking,cap,bonnet,raincoat,trouser,underpants,bowtie,sock,mask,beret
manufacture	construct,produce,create,build,shape,industry,make
science	knowledge
standard	flag
speed	belt,run
sing	song
attach	tie,fasten,connect
rush	charge
carry	stock,keep,have,bear,move
grind	chew
author	write,writer,artist
reverse	back
string	line,thread,cord,lace
wallet	bag
hornet	ladybug,locust,silverfish,beetle,wasp,cockroach,moth,grasshopper,butterfly,dragonfly,ant,cricket,mosquito,fly,bee
giraffe	rat,zebra,pig,whale,sheep,squirrel,okapi,bull,beaver,cat,dog,goat,fox,deer,bear,donkey,tiger,horse,lion,dolphin,elephant,rabbit,cow,gorilla,coyote
tweezer	hatchet,chisel,fork,shovel,screwdriver,sieve,hammer,saw,rake,knife,wrench,spade,spoon,corkscrew
hoof	boot
mosque	cathedral
mold	shape,fungus,cast
marine	sea
stock	carry,share,store
solve	unravel
kippah	hat
sax	flute,violin,guitar,cello,clarinet,trumpet,piano
soil	earth,dirt,land
hill	mound
drive	ride,approach,push,move,trip
line	string,row,cord,edge,thread,letter
expand	increase,spread,develop
tape	record
roof	ceiling
lie	rest,pretend
raft	ferry,battleship,yacht,tanker,frigate
liberty	freedom,independence
drawers	box
stripe	color,band
knowledge	enlightenment,information,light,understand,learn,science
person	human,race,you
deal	handle,agreement,share,lot,commerce,hand,trade,contract
cravat	scarf
experience	life
joint	link,hinge
be	appear,equal,exist
radio	washer,stove,television,phone,fridge,toaster,dishwasher,oven,freezer,telephone,computer,stereo,refrigerator
relief	comfort
grow	cultivate,increase
choose	pick,decide
connect	link,fasten,join,attach
complex	complicate,hard,detail
trust	belief,faith,confidence
wear	use
reindeer	deer
history	log,past,story
come	arrive,appear
rent	lease
hurt	damage,injure
willow	birch,pine,poplar,cypress,oak,acacia,cedar,elm
coat	cloak,sweatshirt,blouse,sweater,socks,bra,raincoat,sock,fleece,shirt,jacket,dress,glove,vest,underpants,scarf,stocking,trousers,pants,stockings,robe,pant,pullover,hat,apron,trouser,fur
robin	oriole,penguin,dove,goose,swan,hawk,falcon,crow,blackbird,eagle,vulture,swallow,sparrow,owl,pigeon,pheasant,woodpecker
color	stripe,race,paint,stain,shade,color
disease	illness,sickness
floor	story
succeed	success
refrigerator	dishwasher,washer,oven,phone,toaster,freezer,stereo,radio,stove,television
smile	beam
residence	dwell,home
ingredient	part
title	crown
eagle	woodpecker,hawk,dove,crow,penguin,falcon,robin,vulture,pigeon,pheasant,owl,goose,sparrow,swan,condor
eraser	rubber
business	trade,company
long	time,high
actress	actor
paper	newspaper
